XXXXXXXXXXXXXXXXXXXXXXXXXXXX
X                          X
X XXXX XXXXX XX XXXXX XXXX X
X XXXXOXXXXX XX XXXXXOXXXX X
X XXXX XXXXX XX XXXXX XXXX X
X                         PX
X XXXX XX XXXXXXXX XX XXXX X
X XXXX XX XXXXXXXX XX XXXX X
X      XX    XX    XX      X
XXXXXX XXXXX XX XXXXX XXXXXX
XXXXXX XXXXX XX XXXXX XXXXXX
XXXXXX XX     G    XX XXXXXX
XXXXXX XX XXX  XXX XX XXXXXX
XXXXXX XX X      X XX XXXXXX
   G      X      X          
XXXXXX XX XXXXXXXX XX XXXXXX
XXXXXX XX X      X XX XXXXXX
XXXXXX XX    G     XX XXXXXX
XXXXXX XX XXXXXXXX XX XXXXXX
XXXXXX XX XXXXXXXX XX XXXXXX
X            XX            X
X XXXX XXXXX XX XXXXX XXXX X
X XXXX XXXXX XX XXXXX XXXX X
X   XX       G        XX   X
XXX XX XX XXXXXXXX XX XX XXX
XXX XX XX XXXXXXXX XX XX XXX
X      XX    XX    XX      X
X XXXXXXXXXX XX XXXXXXXXXX X
X XXXXXXXXXX XX XXXXXXXXXX X
X   O                 O    X
XXXXXXXXXXXXXXXXXXXXXXXXXXXX