XXXXXXXXXXXXXXXXXXXXXXXXXXXX
X                          X
X XXX XX XXXXXXXXXXXXXX OX X
X XXX XX                XX X
X XXX XX XXXXXXXXXXX XX XX X
X XXX XX       X  O  X  XX X
X XXX XX XXXXXXXX XXXXX XX X
X XXX XX                XX X
X XXX XX XXXXXXXX XXXXX XX X
X XXX XX        G       XX X
X XXX XX XXXXXXXXXXXXXX XX X
X XXX XX        O       XX X
X XXX XX XXXXXXXXXXX XX XX X
X XXX XX         X    X XX X
X XXX XX XXXXXX XXXXXXX XX X
X XXXOXX     X          XX X
X G      XXXXXXXXXXXXXX  G X
XXXXXXXXXXXXXXXXXXXXXXXXXXXX