XXXXXXXXXXXXXXXXXXXXXXXXXXXX
X                          X
X XXX XX XXXXXXXXXXXXXX  X X
X XXX XX                XX X
X XXX XX XXXXXXXXXXX XX XX X
X XXX XX       X     X  XX X
X XXX XX XXXXXXXX XXXXX XX X
X XXX XX                XX X
X XXX XX XXXXXXXX XXXXX XX X
X XXX XX                XX X
X XXX XX XXXXXXXXXXXXXX XX X
X XXX XX                XX X
X XXX XX XXXXXXXXXXX XX XX X
X XXX XX         X    X XX X
X XXX XX XXXXXX XXXXXXX XX X
X XXX XX     X          XX X
X        XXXXXXXXXXXXXX    X
XXXXXXXXXXXXXXXXXXXXXXXXXXXX